+-------+-------+-------+
| . . 1 | 7 . . | 5 . 9 |
| 5 7 3 | . 2 4 | 1 . 6 |
| 8 . . | 5 . 1 | . . 2 |
+-------+-------+-------+
| 7 . . | 2 9 5 | . 1 8 |
| . . 9 | 4 . . | 3 . 5 |
| 6 5 2 | 8 . . | . . 7 |
+-------+-------+-------+
| 4 6 5 | . 8 . | . 7 1 |
| . . . | 1 5 9 | . . 4 |
| 9 . 8 | . . 7 | . 5 3 |
+-------+-------+-------+
