###################
# H    #     #X   #
# ###### # ###### #
#        #        #
###################
