###################
#H# X             #
# ############### #
#      # #      # #
# ###### # ###### #
#                 #
###################
