#########
#H      #
# ##### #
# #X    #
# # #####
#       #
# ##### #
#       #
#########
